4 0 0 1 3 2
5 0 0 4 0 4
8 9 0 5 4 6
1 3 2 4 5 5
0 0 4 5 1 2
1 2 5 0 0 0