0 4 1 2 1 2
0 5 0 4 1 2
8 9 0 5 4 0
4 1 3 2 6 4
6 0 4 0 5 6
5 0 5 1 2 5