0 0 0 4 1 2
0 0 4 5 4 4
8 9 5 4 5 5
1 2 0 5 0 4
4 1 3 2 0 5
5 1 2 0 0 0