1 2 4 0 0 0
4 0 5 1 2 0
5 0 8 9 4 0
1 2 0 4 5 0
1 3 2 6 4 0 
1 2 0 5 5 0