4 1 3 2 4 4
5 1 3 2 5 5
8 9 4 4 4 4
0 0 5 5 5 5
0 0 0 4 1 2
0 0 0 5 0 0