0 4 1 2 1 2
0 6 1 2 4 0
0 5 8 9 6 4
1 2 4 4 5 5
0 0 5 5 1 2
0 1 2 1 2 0