1 2 0 4 1 2
4 0 0 6 0 0
5 8 9 5 0 4
0 0 4 1 2 6
1 2 6 0 0 5
1 2 5 0 0 0